Year,Increase,%Increase,Decrease,%Decrease,Total
2008,127,51.626,119,48.374,246
2009,111,45.679,132,54.321,243
2010,115,45.635,137,54.365,252
2011,132,52.8,118,47.2,250
2012,124,49.206,128,50.794,252
2013,117,46.8,133,53.2,250
2014,118,48.361,126,51.639,244
2015,128,51.613,120,48.387,248
2016,124,50.202,123,49.798,247
2017,118,47.581,130,52.419,248
Total,1214,48.950300000000006,1266,51.049699999999994,2480
