Year,Increase,%Increase,Decrease,%Decrease,Total
2008,138,56.098,108,43.902,246
2009,112,46.091,131,53.909,243
2010,131,51.984,121,48.016,252
2011,136,54.4,114,45.6,250
2012,116,46.215,135,53.785,251
2013,129,51.6,121,48.4,250
2014,131,53.689,113,46.311,244
2015,122,49.194,126,50.806,248
2016,115,46.559,132,53.441,247
2017,123,49.597,125,50.403,248
Total,1253,50.5427,1226,49.4573,2479
